1111111111111
1001000000001
100000P111101
11000C0E01111
1111111111111
