111111111
1P0000101
1C0000001
1E00001C1
111111111
